0000000000000000000000000000000000000000000000000000000000000000000000000000000000000000000000000000
0000300000000000000000003000000030000300000000000000300000000000030300000000000000000000000000000000
0000330000030330000000033300000300033330303300303333330003330000333330000000300000303030303000000000
0003333330333333333333333333333333333333333333333333333333333333333333333333300000330303333333333000
0003333333030333333033333333333333333333333333333333333033333333333333333330000003333333333333333300
0003333333333333303330333333333333333330033333303333333333333333333333333333303033333333333333333000
0003333330003333333030333333333333333333333333000033333333333333333333333330333030333303333333333300
0003333333333333333033333333333333333333333030000033333333333333333333333333333300000003333333333000
0003333003000333333333333303333333333333333030000003333333333333333333333333333300300000333003333000
0003333000000333333333333333333333333332233033000003333333333333333333333333333333030003333333333000
0000303303000333333333333333333000333333233333300003333333333333333333303333333333333333333333333000
0000303033222333333233333333330000333303233333330003033333333333333333333333333333333333333333333000
0003333333323333300233333333333000333333333333333303033333333333333333303333333333333333333333333000
0003333333333333032233333033333033333333333333333303033333333333333333333333333333333333333333333000
0003333333333333032203303233333333333333333333333333333333200333333333333333333333333333330333333000
0003333333330303330003303233333333333333333003333333333302203333333333333333333333333030330003333300
0033333333333000000033302233333300033333333300000003333302203333333333333333333333333330302033333330
0003333333030000333333333233333330003333333000030003333300033333333333333330333333333300322003333000
0000333333033000333333303033333300000300333300000000333333333333330003333300303333333300022033333000
0000333303030303333333303033333330000033333000030303333333333333300003330000033333333330033033333000
0003333333333333333333303033333330000333330030330003333303033333000030333000000000003330003333333000
0003330303033333333333303033333330030333333003333333330000333333000030030000000000033330300033333000
0003333333033333330333333333333300033333300333333033333303033333000333303003000000033333000033333330
0003330003333333330333333333333300033333303333333333303303333333000033333333300000333333330003333000
0003333033333333233333333333333000333330033333333333300033333333000033333333030300030303000333333000
0003300003333333222333333333300033333333333333033333300033333333330003333033333000030303333333333000
0003330333333333332233333333333333333333333300033333000303333333303333303333333300000333333333333000
0003330333333333333333000333333333333333333300003333300333333333030333333330333300033333333333333000
0003333333333333333333330303333333333333330030333333033033333333330333333033333333033333333333333000
0003333333333333333333330002333333333333333003033333333333333333033333333333333333333333333333333300
0003333333333333333333330002223333030333333030333333333333333333333333333333333333333333333333333330
0333333333333333033333333032333333030003333333333333333333333333333333333333030333333333333033333300
0033333333333300033333303333333000033333333333333333222233333030333333333303030333330003333300333000
0003333330333300003330303333333333333333333333333030200233333030333333333000003303330000303030333000
0003333333333300033000000330000000333333333333300003000333333030333333330000000333330000300033333000
0003333303033333003300002200000022333333333332230030000333333333333333333000003333333033300003333000
0003333333333333333330000220000322333333323333233033000333333333033333333300333333333333330003333000
0003333333333333333300000223330003333333322333233333333333333333333333333333333333333330333303333000
0003333333333330333300000333033303333333323333333322333333333333003333333333333333333330003333333000
0003333333333333333333330303330300333333333333332222333333333030333333333333333333333000033333333000
0003333333333333333333000333333330033333333333333333333333333330333333333333333330303000033333333300
0003333333330303333333300003033332230333333333330033333333333003333333300033333330300303333333003330
0003003333300003333333333333333332220033333333300033003333322333333330300333333330303333333333300000
0003333333000000333333333333333333000003333333333000003333332233333333003333333333333333333333300300
0003333333300000032223333333333333300033333333333000003333332333333333000333333333333333333333000000
0003333333333000032233333333333332220000033333333000330330003333333300033333333333333333333333000000
0003333333333333333232223333333332333330003333333330333333003333333333333333333333333333333333300000
0003333333333333333332230333333333333300033333333333303333033333333303333333333333333333333333333000
0003333333333333333300033333300033333302033333033333333333333333333333333333333333333333333333333300
0000030333333333333303333330303333333322033300033333333333333333333333330303333333333033333333333300
0000033333333333000033333330300333333323333330003333333333333333333333333333333333333333333333300330
0030003333333000000333334444444444444333333330333330033333333333333333333333333333333033333333300000
0003330333333300000333444444444444004443332333333333333333333333333333333333333333333333333333333300
0003333333333300003344444444444044444444422333333333333333333333333333033333333333333333333333333300
0003333333333300003444444444444040004444442333333333333333333303033333000333333333033333333333333300
0003333333333300004444444444440004404444044433333333333333333333033300033300033333030333333333333300
0003333333333000000444444444444444044444044443333333333333333333333000033300000003030333333333333000
0003333333303030004444444444444440404440404444333333333333333333300000033000330003333333333333333000
0303333333303334444444400444444440404444444444333333333330300000330000333330300003333333333333333000
0003333330000344444444000040444440404444044444433033333330000000000003333333300003333333333333333000
0003333333003444444404400000444444404444444444443333333000033300333333333333333033333333333333333000
0033333333033444444404004000111011144444444004440000303330030033333333330333333333333333333333333000
0003333330334444444444444000111110114444444444424330030300000333303333300033333333333333333033333000
0000333030002224244444411001111111111144444444424030333300000033300333300003333333333333333333333000
0003030303222244224444411110011111111144444444424430330033000300000033333033333330333333333333333000
0000033303324444244444111111111111111114004444444433303030030003330033333033333030303333333333333000
0003033303344444444440001110011111111100004044444400000303333303333333333333333300003333003333033000
0003330333344444444441111111111000011110000440444403000303333333333333333333333003222003303333033000
0003333333344444044440100111111000111100004400000030003333333333333333333000323330222330030003333000
0003333333344444000441111111111000011000440000000400003333333333333333333002223333333000300033333300
0000333333044440000441111111011100010001444400004003033333333333333333330003333333333330303033333330
0000333333344444004441111110011110110000404444040430303333330303333333333003333333333330303333333300
0000033300004440004441111110001000011001444444400000333333333333333333333303333333333333303333333000
0000033330044444444441111111111000010010404444400000333333333333333333333333303333333303033333333000
0000033333344444444441111111110000001100004444000003333333333333333333333333300003333333333303333000
0000333333344444444444111111110000011000000440000003333330333333333033333333030000033303300300033000
0000333333344444444444411111110012011100000440000433333330333333333000333333333000333333000033003000
0003333333334404444444401001111102221144004000000033333333333333333303333333330303303333300300303000
0003333333334000044444400000111111114444040004000333333333333300333333333333333333300333333033003300
0003333333333000044444400000011001144444440040443333333333333003333333333333333333300033330300000300
0003333333330400044444400000444444444444444444443330303333330003333333333333333333220303330000000300
0003333330030344444444400444044444444444444444433303033333333333333333333333333333233333000000000000
0033333300030304444400004044444444444444444440003330033333333333322233333333333033233333300033003000
0033333000030334444400000004404444444444444444033000333333333033220003333333333032233333333333333300
0003333300003333444440000004044444444444444400300333333333333033230033333333333030333333333333333330
0033303030003333344444400000004444444444440403330333333333333330303033333333333333333333333333333300
0000303300033000333444440404044444444444443000330333333303333330303333333333333333333333330233333000
0000333333333000333344444040044440444444430000303333330003333330003333333333333333333333322233333000
0003333333000003333333440404444444444443000000003333333030333300003333333333333333322333322033333300
0003333333303030333333030004044404042333300003333333333333333300000333333333333333322233333333333330
0003333330003033333333030003333330322333033033333333333333330033000333333333333333303030333333333300
0003333330303333333333333300333300033333003330333333333333333300000330003333333333333033333333333000
0003330303003330333333333333333333333333000003333333333333303300000333333333333333333333333303033000
0003000333333333333333333333333333333330033330033333330000003330003300303333333333333333330333033000
0003000033333303033333333333333333333330303330033333330030033330003333333333333333333333300003033300
0033000333333333333330333333333333333330033300333333300300330333333330333333333303030333303003033330
0000033333333303333003333333333333333333333303033333333333000333333333333333030303333333330000003300
0000030033333333300030000000000000000000000000000003000003000030030300000000303030303000303000000000
0000000003030003000003300000000000000000300000000030000000000000000000000000000000000000030000000000
0000000000000000000000000000000000000000000000000000000000000000000000000000000000000000000000000000
